 ####### 
##.$ $.##
#.* $ *.#
#  $@$  #
#.* $ *.#
##.$ $.##
 ####### 