########
# $    #
###    #
#  . @ #
########
