########
#  .*  #
#  $ $ #
# @*.  #
########
