 ####  ######
 #  ####    #
##*   * **  #
# $ *    *  #
# .   ### @ #
####### #####