########
#  **  #
#  @   #
#  **  #
########
