########
# $.*  #
#  @   #
#  **  #
########
