########
#  .$$.#
# . $$.#
#  @ $.#
# .$$$.#
########
