#########   #####
#   #   #   #   #
# # # # #####.# #
# .$ $. #   # $ #
#### #### # # #####
 #        $    .. #
 # #$####*### ### #
 #   # #@ # #     #
 ##### #### #######
 