########
# $. $.#
#@.$ $.#
# $. $.#
# .$ $.#
########