########     
# .  . #     
# #$$$*#     
#    #.#     
# $ $$ #     
# * .#.#     
#.$.$ #######
#  .$.@     #
# ##### ### #
#           #
#############