#######
###   #
#@ .$.#
#  $ $#
###.$.#
###   #
#######
