 #######
 #     #
## .$. #
#@ $ $ #
#  .$. #
##     #
 #######
